NO ./assets/north_wall.xpm
EA ./assets/east_wall.xpm
SO ./assets/south_wall.xpm
WE ./assets/west_wall.xpm

F 26,0,0
C 51,0,0

111111111111111111111111
100000000000000000000001
100000000000100000000001
100000000000000000000001
100000000000E00000000001
100000000000000000000001
100000000000000000000001
100000000000000000000001
100000000000000000000001
100000000000000000000001
100000000000000000000001
111111111111111111111111
